mov: A
push: B
call: C
pop: D
add: E
cmp: F
retn: G
jmp: H
jz: I
lea: J
xor: K
test: L
jnz: M
sub: N
dec: O
inc: P
and: Q
jl: R
jle: S
movzx: T
or: U
jg: V
jnb: W
jge: X
jb: Y
imul: Z
jbe: [
ja: \
shl: ]
default: ^
