A: mov
B: push
C: call
D: pop
E: add
F: cmp
G: retn
H: jmp
I: jz
J: lea
K: xor
L: test
M: jnz
N: sub
O: dec
P: inc
Q: and
R: jl
S: jle
T: movzx
U: or
V: jg
W: jnb
X: jge
Y: jb
Z: imul
[: jbe
\: ja
]: shl
^: default
