mov: A
push: B
add: C
jz: D
cmp: E
pop: F
call: G
inc: H
lea: I
jnz: J
test: K
xchg: L
dec: M
retn: N
xor: O
and: P
sub: Q
jmp: R
jl: S
setalc: T
or: U
sbb: V
adc: W
jo: X
cmpsd: Y
jb: Z
imul: [
leave: \
popa: ]
default: ^
