A: mov
B: push
C: add
D: jz
E: cmp
F: pop
G: call
H: inc
I: lea
J: jnz
K: test
L: xchg
M: dec
N: retn
O: xor
P: and
Q: sub
R: jmp
S: jl
T: setalc
U: or
V: sbb
W: adc
X: jo
Y: cmpsd
Z: jb
[: imul
\: leave
]: popa
^: default
