mov: A
add: B
push: C
sub: D
adc: E
jnz: F
inc: G
lea: H
call: I
jmp: J
cmp: K
jnb: L
jz: M
or: N
pop: O
xchg: P
jb: Q
ja: R
xor: S
and: T
dec: U
shr: V
shl: W
jbe: X
pusha: Y
repne: Z
loop: [
rol: \
popa: ]
default: ^
