A: mov
B: add
C: push
D: sub
E: adc
F: jnz
G: inc
H: lea
I: call
J: jmp
K: cmp
L: jnb
M: jz
N: or
O: pop
P: xchg
Q: jb
R: ja
S: xor
T: and
U: dec
V: shr
W: shl
X: jbe
Y: pusha
Z: repne
[: loop
\: rol
]: popa
^: default
