mov: A
jmp: B
sbb: C
adc: D
add: E
push: F
and: G
pop: H
retn: I
sub: J
clc: K
call: L
xor: M
ja: N
jnz: O
xchg: P
lodsd: Q
hlt: R
int: S
or: T
cmp: U
cmc: V
stc: W
jnb: X
popa: Y
dec: Z
stosb: [
sal: \
inc: ]
default: ^
