mov: A
push: B
call: C
lea: D
jmp: E
nop: F
sub: G
pop: H
retn: I
add: J
xor: K
cmp: L
jge: M
test: N
jo: O
jnz: P
fnclex: Q
adc: R
and: S
movsx: T
jz: U
or: V
fnstsw: W
fild: X
fdiv: Y
jg: Z
fsub: [
wait: \
: ]
default: ^
