A: mov
B: push
C: call
D: lea
E: jmp
F: nop
G: sub
H: pop
I: retn
J: add
K: xor
L: cmp
M: jge
N: test
O: jo
P: jnz
Q: fnclex
R: adc
S: and
T: movsx
U: jz
V: or
W: fnstsw
X: fild
Y: fdiv
Z: jg
[: fsub
\: wait
]: 
^: default
