mov: A
add: B
sub: C
adc: D
jnz: E
push: F
inc: G
jz: H
jmp: I
cmp: J
call: K
or: L
jnb: M
lea: N
jb: O
ja: P
xor: Q
retn: R
xchg: S
pop: T
outsd: U
dec: V
shr: W
shl: X
sbb: Y
jbe: Z
fisttp: [
sti: \
pusha: ]
default: ^
