A: mov
B: add
C: sub
D: adc
E: jnz
F: push
G: inc
H: jz
I: jmp
J: cmp
K: call
L: or
M: jnb
N: lea
O: jb
P: ja
Q: xor
R: retn
S: xchg
T: pop
U: outsd
V: dec
W: shr
X: shl
Y: sbb
Z: jbe
[: fisttp
\: sti
]: pusha
^: default
