A: mov
B: jmp
C: sbb
D: adc
E: add
F: push
G: and
H: pop
I: retn
J: sub
K: clc
L: call
M: xor
N: ja
O: jnz
P: xchg
Q: lodsd
R: hlt
S: int
T: or
U: cmp
V: cmc
W: stc
X: jnb
Y: popa
Z: dec
[: stosb
\: sal
]: inc
^: default
